NO ./mandatory/textures/colorstone.png
SO ./mandatory/textures/greystone.png
WE ./mandatory/textures/redbrick.png
EA ./mandatory/textures/bluestone.png

F 162,95,53
C 110,169,245a
111111111111111
100000000000001
100000000000001
100000010000001
100000101000001
100000010000001
100000000000001
100000W00000001
100000000000001
11111111111111
