NO textures/colorstone.png
SO textures/greystone.png
WE textures/redbrick.png
EA textures/bluestone.png

F 162,95,53
C 255,255,255
111111111111111
100000000000001
100000000000001
100000010000001
100000101000001
100000010000001
100000000000001
100000W00000001
100000000001001
11111111111 111
