NO ./textures/nord.png
SO ./textures/south.png
WE ./textures/west.png
EA ./textures/east.png
F 25,255,255
C 25,255,255
111111111111111
100000000000001
100000000000001
100000000000001
100010100000001
100001000000001
100000000000001
100000000000001
100000000E00001
11111111111111
