NO ./textures/colorstone.png
SO ./textures/greystone.png
WE ./textures/redbrick.png
EA ./textures/bluestone.png

F 162,95,53
C 110,169,245a
111111111111111
100000000000001
100000000000001
100000000000001
100000100000001
100000W00000001
100000000000001
100000000000001
100000000000001
11111111111111
