                F 162,95,53
EA ./textures/wood.png
NO ./textures/colorstone.png



SO ./textures/barrel.png

WE ./textures/redbrick.png


C 110,169,245





      111111111111111111111
        1000000000110000000000001
        1011000001110000000000001
        10010000S0000000000000001
111111111011000001110000000000001
100000000001000001110111111111111
11110111110111011100000010001
111101111101110111010100D0001
11000001110111011100000010001
10000001000010001100000101001
10000001111110001101010010001
110000011101010111110111000111
11110111 1110101 101111010001
11111111 1111111 111111111111
    