EA textures/1.png
NO textures/3.png
SO textures/8.png


WE textures/6.png


D textures/door.png

C textures/ceiling.png

F 66,33,00



11111111111111111111111111111111
100000000011000000000000000001011
100000000011000000000000000001011
100000000011000000000000000001011
100000000011000000000000000001011
1000000000DD000000000000000001011
100000000011000000000000000001011
100000000011000000000000000001011
100000000011000000000000000001011
10000000000D000000000000000001011
100000000011000000000000000001011
1011000001110011D1000000111101111
10010000000000000000000011111111111111
1111111111111011000001110000000000001
1000000000110000011101111111111111111
11110111111111011100000010001
11110111111111011101010010001
11000000110101011100000000101
100000000000000011000001D1D111
100000000000000011010101D100101
11000001110101011111011000N0111
11110111 1110101 1011110000011
11111111 1111111 111111111111